111111
100101
101001
1100;N1
111111