NO ./briani.xpm


SO ./redbrick.xpm
WE ./gstone.xpm     

EA ./wood.xpm

F 165,42,42
C 135,206,235

1111111111
1000000001
1001000001
1000000001
1000000001       
1000000001
1000000001
1000000001 
1000000001
100E000001
1000000001
1000000011
1111111111
