NO ./sprites/path_to_the_north_texture
SO ./sprites/path_to_the_south_texture
EA ./sprites/path_to_the_east_texture



WE ./sprites/path_to_the_west_texture

F 55,5,56
C 225,30,0

11111111111111111111111
1000000000110000000000011
10110000011100000000000011111        1111111111
11 1001000000000000000000001           100100001                    
111111111111111111111111111111111   111111111111 
111111111011000001110000000000001
1000000000110000111011111111111111
11111111111111111111111111111111
111111111111111111111111111111111  
11110111111111011100000010001 
11110111111111011101010010001
11000000110101011100000010001  
10000000000000001100000010001
10000000000000001101010010011
1100000111010101111101111S0111
11110111 1110101 1011110100011
11111111111111111111111111111111111111111111111111
